type octile
height 19
width 33
map
..@@@@@@@@@@@@@@@@@.......@@@@@..
..@@@@@@@@@@@@@@@@.........@@@@..
..@@@@@@@@@@@@@@@...........@@@..
..@@@@@@@@@@@@@@.............@@..
..@@@@@@@@@@@@@.........@.....@..
..@@@@@@@@@@@@.........@@@.......
..@@@@@@@@@@@.........@@@@@......
..@@@@@@@@@@.........@@@@@@@.....
..@@@@@@@@@.........@@@@@@@@@....
.............@@@@@@@.............
....@@@@@@@@@.........@@@@@@@@@..
.....@@@@@@@.........@@@@@@@@@@..
......@@@@@.........@@@@@@@@@@@..
.......@@@.........@@@@@@@@@@@@..
..@.....@.........@@@@@@@@@@@@@..
..@@.............@@@@@@@@@@@@@@..
..@@@...........@@@@@@@@@@@@@@@..
..@@@@.........@@@@@@@@@@@@@@@@..
..@@@@@.......@@@@@@@@@@@@@@@@@..

